FQFFFFWFFF
FGFFFFFFFD
FFFFFFFFFF
DFFFFFFFGF
FFFWFFFFQF
